##########################
##########################
/\-<>-/\-<>-/\-<>-/\-<>-/\
{}####{}#{}#{}####{}####{}
{}####{}#{}#{}####{}####{}
{}####{}#{}#{}####{}####{}
[]-<>-[]#{}#[]-<>-[]-<>-[]
###{}#{}#{}#{}#{}#{}####{}
###{}#[]#()-[]#{}#{}####{}
###{}#{}####{}#{}#{}####{}
/\-()-[]####{}#{}#[]-<>-[]
{}#{}#{}####{}#{}#{}#{}###
{}#{}#[]-<>-[]-()-[]#{}###
{}#{}#{}####{}####{}#{}###
{}#{}#{}####{}####[]-()-/\
{}#{}#{}####{}####{}#{}#{}
[]-()-[]-<>-[]-<>-[]#{}#{}
{}####{}####{}####{}#{}#{}
{}####{}####{}####{}#{}#{}
{}####{}####{}####{}#{}#{}
[]----[]-<>-[]----[]-()-[]
##########################
##########################
##########################
##########################
#puuuuqpuuuuqpuuuuqpuuuuq#